AAXXXXXXXXXXXXXXXXXXXXX
AAXOOOOOXOOOOOXOOOOOOOX
AAXOXXXOXOXOXXXXXXXOXOX
AAXOOOXOXOXOXOOOOOXOXOX
AAXXXOXOXOXOXOXXXOOOXXX
AAXOOOXOOOXOOOXOOOXOOOX
AAXXXOXXXXXXXOXOXXXXXOX
AAXOXOOOOOOOOOXOXOOOXOX
AAXOXOXXXOXXXOXOXOXOXOX
AAXOXOXOXOXOOOXOOOXOXOX
AAXOXOXOXOXOXXXOXXXOXXX
AAXOOOXOOOXOXOOOOOXOOOX
AAXXXOXXXXXOXXXOXOXXXOX
AAXOOOOOOOOOOOOOXOXOOOX
AAXXXOXXXOXOXXXXXOXOXOX
AAXOXOXOXOXOOOOOXOXOXOX
AAXOXOXOXOXXXXXOXOXOXOX
AAXOOOXOXOOOOOXOOOOOXOX
AAXOXOOOOOXOXOOOXOXOXOX
AAXXXXXXXXXXXXXXXXXXXXX